{
    "name": "Level001",
    "mapSize": {
        "X": 39,
        "Y": 35
    },
    "map": [
        [  5,   1,   1,   1,   1,   1,   1,   1,   1,   1,   1,   1,   1,   1,   1,   1,   1,   1,   1,   1,   1,   1,   1,   1,   1,   1,   1,  44,  52,  45,   1,   1,   1,   1,   1,   1,   1,   1,   6],
        [  3,   0,   0,   0,   0,   0,   0,   0,   0,   0,   0,   0,   0,   0,   0,   0,   0,   0,   0,   0,   0,   0,   0,   0,   0,   0,   0,   0,   0,   0,   0,   0,   0,   0,   0,   0,   0,   0,   4],
        [  3,   0,  13,   9,   9,   9,   9,   9,   9,  14,   0,  13,   9,   9,   9,   9,   9,   9,  14,   0,  13,   9,   9,   9,   9,   9,   9,  14,   0,  13,   9,   9,   9,   9,   9,   9,  14,   0,   4],
        [  3,   0,  11,  37,  10,  10,  10,  10,  10,  16,   0,  15,  10,  10,  10,  10,  10,  36,  12,   0,  11,  37,  10,  10,  10,  10,  10,  16,   0,  15,  10,  10,  10,  10,  10,  36,  12,   0,   4],
        [  3,   0,  11,  12,   0,   0,   0,   0,   0,   0,   0,   0,   0,   0,   0,   0,   0,  11,  12,   0,  11,  12,   0,   0,   0,   0,   0,   0,   0,   0,   0,   0,   0,   0,   0,  11,  12,   0,   4],
        [  3,   0,  11,  12,   0,  13,   9,   9,   9,  14,   0,  13,   9,   9,   9,  14,   0,  11,  12,   0,  11,  12,   0,  13,   9,   9,   9,  14,   0,  13,   9,   9,   9,  14,   0,  11,  12,   0,   4],
        [  3,   0,  11,  12,   0,  11,  37,  10,  10,  16,   0,  15,  10,  10,  36,  12,   0,  11,  12,   0,  11,  12,   0,  11,  37,  10,  10,  16,   0,  15,  10,  10,  36,  12,   0,  11,  12,   0,   4],
        [  3,   0,  11,  12,   0,  11,  12,   0,   0,   0,   0,   0,   0,   0,  11,  12,   0,  11,  12,   0,  11,  12,   0,  11,  12,   0,   0,   0,   0,   0,   0,   0,  11,  12,   0,  11,  12,   0,   4],
        [ 48,   0,  15,  16,   0,  11,  12,   0,  13,   9,   9,   9,  14,   0,  11,  12,   0,  11,  12,   0,  11,  12,   0,  11,  12,   0,  13,   9,   9,   9,  14,   0,  11,  12,   0,  15,  16,   0,   4],
        [ 52,   0,   0,   0,   0,  11,  12,   0,  11,  40,  40,  40,  12,   0,  11,  12,   0,  11,  12,   0,  11,  12,   0,  11,  12,   0,  11,  40,  40,  40,  12,   0,  11,  12,   0,   0,   0,   0,   4],
        [ 49,   0,  13,  14,   0,  11,  12,   0,  15,  10,  10,  10,  16,   0,  15,  16,   0,  15,  16,   0,  15,  16,   0,  15,  16,   0,  15,  10,  10,  10,  16,   0,  11,  12,   0,  13,  14,   0,   4],
        [  3,   0,  11,  12,   0,  11,  12,   0,   0,   0,   0,   0,   0,   0,   0,   0,   0,   0,   0,   0,   0,   0,   0,   0,   0,   0,   0,   0,   0,   0,   0,   0,  11,  12,   0,  11,  12,   0,   4],
        [  3,   0,  11,  12,   0,  11,  39,   9,   9,  14,   0,  13,   9,  14,   0,  24,  20,  17,  19,  19,  19,  18,  20,  25,   0,  13,   9,  14,   0,  13,   9,   9,  38,  12,   0,  11,  12,   0,   4],
        [  3,   0,  11,  12,   0,  15,  10,  10,  10,  16,   0,  15,  10,  16,   0,  22,  41,  41,  41,  41,  41,  41,  41,  23,   0,  15,  10,  16,   0,  15,  10,  10,  10,  16,   0,  11,  12,   0,   4],
        [  3,   0,  11,  12,   0,   0,   0,   0,   0,   0,   0,   0,   0,   0,   0,  22,  41,  41,  41,  41,  41,  41,  41,  23,   0,   0,   0,   0,   0,   0,   0,   0,   0,   0,   0,  11,  12,   0,   4],
        [  3,   0,  11,  39,   9,   9,   9,   9,   9,  14,   0,  13,   9,  14,   0,  22,  41,  41,  41,  41,  41,  41,  41,  23,   0,  13,   9,  14,   0,  13,   9,   9,   9,   9,   9,  38,  12,   0,   4],
        [  3,   0,  15,  10,  10,  10,  10,  10,  10,  16,   0,  15,  10,  16,   0,  26,  21,  21,  21,  21,  21,  21,  21,  27,   0,  15,  10,  16,   0,  15,  10,  10,  10,  10,  10,  10,  16,   0,   4],
        [  3,   0,   0,   0,   0,   0,   0,   0,   0,   0,   0,   0,   0,   0,   0,   0,   0,   0,   0,   0,   0,   0,   0,   0,   0,   0,   0,   0,   0,   0,   0,   0,   0,   0,   0,   0,   0,   0,   4],
        [  3,   0,  13,   9,   9,   9,   9,   9,   9,  14,   0,  13,   9,   9,   9,   9,   9,   9,  14,   0,  13,   9,   9,   9,   9,   9,   9,  14,   0,  13,   9,   9,   9,   9,   9,   9,  14,   0,   4],
        [  3,   0,  11,  37,  10,  10,  10,  10,  10,  16,   0,  15,  10,  10,  10,  10,  10,  36,  12,   0,  11,  37,  10,  10,  10,  10,  10,  16,   0,  15,  10,  10,  10,  10,  10,  36,  12,   0,   4],
        [  3,   0,  11,  12,   0,   0,   0,   0,   0,   0,   0,   0,   0,   0,   0,   0,   0,  11,  12,   0,  11,  12,   0,   0,   0,   0,   0,   0,   0,   0,   0,   0,   0,   0,   0,  11,  12,   0,   4],
        [  3,   0,  11,  12,   0,  13,   9,   9,   9,  14,   0,  13,   9,   9,   9,  14,   0,  11,  12,   0,  11,  12,   0,  13,   9,   9,   9,  14,   0,  13,   9,   9,   9,  14,   0,  11,  12,   0,   4],
        [  3,   0,  11,  12,   0,  11,  37,  10,  10,  16,   0,  15,  10,  10,  36,  12,   0,  11,  12,   0,  11,  12,   0,  11,  37,  10,  10,  16,   0,  15,  10,  10,  36,  12,   0,  11,  12,   0,   4],
        [  3,   0,  11,  12,   0,  11,  12,   0,   0,   0,   0,   0,   0,   0,  11,  12,   0,  11,  12,   0,  11,  12,   0,  11,  12,   0,   0,   0,   0,   0,   0,   0,  11,  12,   0,  11,  12,   0,   4],
        [  3,   0,  15,  16,   0,  11,  12,   0,  13,   9,   9,   9,  14,   0,  11,  12,   0,  15,  16,   0,  15,  16,   0,  11,  12,   0,  13,   9,   9,   9,  14,   0,  11,  12,   0,  15,  16,   0,  50],
        [  3,   0,   0,   0,   0,  11,  12,   0,  11,  40,  40,  40,  12,   0,  11,  12,   0,   0,   0,   0,   0,   0,   0,  11,  12,   0,  11,  40,  40,  40,  12,   0,  11,  12,   0,   0,   0,   0,  52],
        [  3,   0,  13,  14,   0,  11,  12,   0,  15,  10,  10,  10,  16,   0,  11,  12,   0,  13,  14,   0,  13,  14,   0,  11,  12,   0,  15,  10,  10,  10,  16,   0,  11,  12,   0,  13,  14,   0,  51],
        [  3,   0,  11,  12,   0,  11,  12,   0,   0,   0,   0,   0,   0,   0,  11,  12,   0,  11,  12,   0,  11,  12,   0,  11,  12,   0,   0,   0,   0,   0,   0,   0,  11,  12,   0,  11,  12,   0,   4],
        [  3,   0,  11,  12,   0,  11,  39,   9,   9,  14,   0,  13,   9,   9,  38,  12,   0,  11,  12,   0,  11,  12,   0,  11,  39,   9,   9,  14,   0,  13,   9,   9,  38,  12,   0,  11,  12,   0,   4],
        [  3,   0,  11,  12,   0,  15,  10,  10,  10,  16,   0,  15,  10,  10,  10,  16,   0,  11,  12,   0,  11,  12,   0,  15,  10,  10,  10,  16,   0,  15,  10,  10,  10,  16,   0,  11,  12,   0,   4],
        [  3,   0,  11,  12,   0,   0,   0,   0,   0,   0,   0,   0,   0,   0,   0,   0,   0,  11,  12,   0,  11,  12,   0,   0,   0,   0,   0,   0,   0,   0,   0,   0,   0,   0,   0,  11,  12,   0,   4],
        [  3,   0,  11,  39,   9,   9,   9,   9,   9,  14,   0,  13,   9,   9,   9,   9,   9,  38,  12,   0,  11,  39,   9,   9,   9,   9,   9,  14,   0,  13,   9,   9,   9,   9,   9,  38,  12,   0,   4],
        [  3,   0,  15,  10,  10,  10,  10,  10,  10,  16,   0,  15,  10,  10,  10,  10,  10,  10,  16,   0,  15,  10,  10,  10,  10,  10,  10,  16,   0,  15,  10,  10,  10,  10,  10,  10,  16,   0,   4],
        [  3,   0,   0,   0,   0,   0,   0,   0,   0,   0,   0,   0,   0,   0,   0,   0,   0,   0,   0,   0,   0,   0,   0,   0,   0,   0,   0,   0,   0,   0,   0,   0,   0,   0,   0,   0,   0,   0,   4],
        [  7,   2,   2,   2,   2,   2,   2,   2,   2,  46,  52,  47,   2,   2,   2,   2,   2,   2,   2,   2,   2,   2,   2,   2,   2,   2,   2,   2,   2,   2,   2,   2,   2,   2,   2,   2,   2,   2,   8]
    ],
    "lifeSystemPosition":{
        "X": -344,
        "Y": -248
    },
    "lifeSystemHitPoint": 3,
    "fruitSystemPosition":{
        "X": 328,
        "Y": -248
    },
    "gameScorePosition":{
        "X": -382,
        "Y": 240
    },
    "hightScorePosition":{
        "X": 372,
        "Y": 240
    },
    "ghostName":["blinky", "pinky", "inky", "clyde"],
    "ghostInitialPosition":[
        [-8,  120],
        [-40,   72],
        [-8,   72],
        [24,   72]
    ],
    "ghostRestartPosition": {
        "X": -8.0,
        "Y": 72.0
    },
    "cherryPosition": {
        "X": -8.0,
        "Y": 24.0
    },
    "pacmanDeadImages":[
        "/Image/Character/Pacman_dead/Pacman_dead1.png",
        "/Image/Character/Pacman_dead/Pacman_dead2.png",
        "/Image/Character/Pacman_dead/Pacman_dead3.png",
        "/Image/Character/Pacman_dead/Pacman_dead4.png",
        "/Image/Character/Pacman_dead/Pacman_dead5.png",
        "/Image/Character/Pacman_dead/Pacman_dead6.png",
        "/Image/Character/Pacman_dead/Pacman_dead7.png",
        "/Image/Character/Pacman_dead/Pacman_dead8.png",
        "/Image/Character/Pacman_dead/Pacman_dead9.png",
        "/Image/Character/Pacman_dead/Pacman_dead10.png",
        "/Image/Character/Pacman_dead/Pacman_dead11.png",
        "/Image/Character/Pacman_dead/Pacman_dead12.png",
        "/Image/Character/Pacman_dead/Pacman_dead13.png"
    ],
    "pacmanUpImages":["/Image/Character/pacman/pacman_U_01.png", "/Image/Character/pacman/pacman_U_02.png"],
    "pacmanDownImages":["/Image/Character/pacman/pacman_D_01.png", "/Image/Character/pacman/pacman_D_02.png"],
    "pacmanRightImages":["/Image/Character/pacman/pacman_R_01.png", "/Image/Character/pacman/pacman_R_02.png"],
    "pacmanLeftImages":["/Image/Character/pacman/pacman_L_01.png", "/Image/Character/pacman/pacman_L_02.png"],
    "pacmanPosition":{
        "X": -8.0,
        "Y": -104
    },
    "Vulnerable":{
        "blinky":{
            "max":[-8,  296],
            "min":[-312, 120]
        },
        "pinky": {
            "max":[296,  296],
            "min":[-8,  120]
        },
        "inky": {
            "max":[ -8,  -72],
            "min":[-312, -248]
        },
        "clyde": {
            "max":[ 296,  -72],
            "min":[ -8, -248]
        }
    },
    "jumpPoint":[
        [[136,  296],[-152, -248]],
        [[-152, -248],[136,  296]],
        [[-312,  152],[296, -104]],
        [[296, -104],[-312,  152]]
    ]
}