{
    "name": "Level001",
    "mapSize": {
        "X": 28,
        "Y": 31
    },
    "map": [
        [5,  1,  1,  1,  1,  1,  1,  1,  1,  1,  28, 29, 1,  1,  1,  1,  28, 29, 1,  1,  1,  1,  1,  1,  1,  1,  1,  6],
        [3,  43, 0,  0,  0,  0,  0,  0,  0,  0,  11, 12, 0,  0,  0,  0,  11, 12, 0,  0,  0,  0,  0,  0,  0,  0,  43, 4],
        [3,  0,  13, 9,  9,  14, 0,  13, 14, 0,  11, 12, 0,  13, 14, 0,  11, 12, 0,  13, 14, 0,  13, 9,  9,  14, 0,  4],
        [3,  0,  15, 10, 10, 16, 0,  11, 12, 0,  15, 16, 0,  11, 12, 0,  15, 16, 0,  11, 12, 0,  15, 10, 10, 16, 0,  4],
        [3,  0,  0,  0,  0,  0,  0,  11, 12, 0,  0,  0,  0,  11, 12, 0,  0,  0,  0,  11, 12, 0,  0,  0,  0,  0,  0,  4],
        [3,  0,  13, 9,  9,  14, 0,  11, 39, 9,  9,  14, 0,  11, 12, 0,  13, 9,  9,  38, 12, 0,  13, 9,  9,  14, 0,  4],
        [3,  0,  11, 37, 10, 16, 0,  15, 10, 10, 10, 16, 0,  11, 12, 0,  15, 10, 10, 10, 16, 0,  15, 10, 36, 12, 0,  4],
        [3,  0,  11, 12, 0,  0,  0,  0,  0,  0,  0,  0,  0,  11, 12, 0,  0,  0,  0,  0,  0,  0,  0,  0,  11, 12, 0,  4],
        [3,  0,  11, 12, 0,  13, 9,  9,  14, 42, 13, 9,  9,  38, 39, 9,  9,  14, 42, 13, 9,  9,  14, 0,  11, 12, 0,  4],
        [3,  0,  15, 16, 0,  15, 10, 10, 16, 42, 15, 10, 10, 10, 10, 10, 10, 16, 42, 15, 10, 10, 16, 0,  15, 16, 0,  4],
        [3,  0,  0,  0,  0,  0,  0,  42, 42, 42, 42, 42, 42, 42, 42, 42, 42, 42, 42, 42, 42, 0,  0,  0,  0,  0,  0,  4],
        [3,  0,  13, 9,  9,  14, 0,  13, 14, 42, 24, 20, 17, 19, 19, 18, 20, 25, 42, 13, 14, 0,  13, 9,  9,  14, 0,  4],
        [3,  0,  11, 40, 40, 12, 0,  11, 12, 42, 22, 41, 41, 41, 41, 41, 41, 23, 42, 11, 12, 0,  11, 40, 40, 12, 0,  4],
        [3,  0,  15, 10, 10, 16, 0,  11, 12, 42, 22, 41, 41, 41, 41, 41, 41, 23, 42, 11, 12, 0,  15, 10, 10, 16, 0,  4],
        [3,  0,  0,  0,  0,  0,  0,  11, 12, 42, 22, 41, 41, 41, 41, 41, 41, 23, 42, 11, 12, 0,  0,  0,  0,  0,  0,  4],
        [3,  0,  13, 9,  9,  14, 0,  11, 12, 42, 26, 21, 21, 21, 21, 21, 21, 27, 42, 11, 12, 0,  13, 9,  9,  14, 0,  4],
        [3,  0,  15, 10, 36, 12, 0,  11, 12, 42, 42, 42, 42, 42, 42, 42, 42, 42, 42, 11, 12, 0,  11, 37, 10, 16, 0,  4],
        [3,  0,  0,  0,  11, 12, 0,  11, 12, 42, 13, 9,  9,  9,  9,  9,  9,  14, 42, 11, 12, 0,  11, 12, 0,  0,  0,  4],
        [35, 9,  14, 0,  11, 12, 0,  15, 16, 42, 15, 10, 10, 36, 37, 10, 10, 16, 42, 15, 16, 0,  11, 12, 0,  13, 9,  33],
        [34, 10, 16, 0,  11, 12, 0,  0,  0,  0,  0,  0,  0,  11, 12, 0,  0,  0,  0,  0,  0,  0,  11, 12, 0,  15, 10, 32],
        [3,  0,  0,  0,  11, 12, 0,  13, 9,  9,  9,  14, 0,  11, 12, 0,  13, 9,  9,  9,  14, 0,  11, 12, 0,  0,  0,  4],
        [3,  0,  13, 9,  38, 12, 0,  11, 37, 10, 10, 16, 0,  15, 16, 0,  15, 10, 10, 36, 12, 0,  11, 39, 9,  14, 0,  4],
        [3,  0,  15, 10, 10, 16, 0,  11, 12, 0,  0,  0,  0,  42, 0,  0,  0,  0,  0,  11, 12, 0,  15, 10, 10, 16, 0,  4],
        [3,  0,  0,  0,  0,  0,  0,  11, 12, 0,  13, 14, 0,  13, 14, 0,  13, 14, 0,  11, 12, 0,  0,  0,  0,  0,  0,  4],
        [3,  0,  13, 14, 0,  13, 9,  38, 12, 0,  11, 12, 0,  11, 12, 0,  11, 12, 0,  11, 39, 9,  14, 0,  13, 14, 0,  4],
        [3,  0,  11, 12, 0,  15, 10, 10, 16, 0,  11, 12, 0,  15, 16, 0,  11, 12, 0,  15, 10, 10, 16, 0,  11, 12, 0,  4],
        [3,  0,  11, 12, 43, 0,  0,  0,  0,  0,  11, 12, 0,  0,  0,  0,  11, 12, 0,  0,  0,  0,  0,  43, 11, 12, 0,  4],
        [3,  0,  11, 39, 9,  9,  9,  9,  14, 0,  11, 39, 9,  9,  9,  9,  38, 12, 0,  13, 9,  9,  9,  9,  38, 12, 0,  4],
        [3,  0,  15, 10, 10, 10, 10, 10, 16, 0,  15, 10, 10, 10, 10, 10, 10, 16, 0,  15, 10, 10, 10, 10, 10, 16, 0,  4],
        [3,  0,  0,  0,  0,  0,  0,  0,  0,  0,  0,  0,  0,  0,  0,  0,  0,  0,  0,  0,  0,  0,  0,  0,  0,  0,  0,  4],
        [7,  2,  2,  2,  2,  2,  2,  2,  2,  2,  2,  2,  2,  2,  2,  2,  2,  2,  2,  2,  2,  2,  2,  2,  2,  2,  2,  8]
    ],
    "lifeSystemPosition":{
        "X": -256,
        "Y": -216
    },
    "lifeSystemHitPoint": 3,
    "fruitSystemPosition":{
        "X": 240,
        "Y": -216
    },
    "gameScorePosition":{
        "X": -294,
        "Y": 208
    },
    "hightScorePosition":{
        "X": 284,
        "Y": 208
    }

}

