{
    "name": "Level001",
    "mapSize": {
        "X": 33,
        "Y": 33
    },
    "map": [
        [  5,   1,   1,   1,   1,   1,   1,   1,  28,  29,   1,   1,   1,   1,   1,   1,   1,   1,   1,   1,   1,   1,   1,  28,  29,   1,   1,   1,   1,   1,   1,   1,   6],
        [  3,  43,   0,   0,   0,   0,   0,   0,  11,  12,   0,   0,   0,   0,   0,   0,   0,   0,   0,   0,   0,   0,   0,  11,  12,   0,   0,   0,   0,   0,   0,  43,   4],
        [  3,   0,  13,  14,   0,  13,  14,   0,  11,  12,   0,  13,   9,   9,   9,   9,   9,   9,   9,   9,   9,  14,   0,  11,  12,   0,  13,  14,   0,  13,  14,   0,   4],
        [  3,   0,  11,  12,   0,  11,  12,   0,  11,  12,   0,  15,  10,  10,  10,  10,  10,  10,  10,  10,  10,  16,   0,  11,  12,   0,  11,  12,   0,  11,  12,   0,   4],
        [  3,   0,  11,  12,   0,  11,  12,   0,  11,  12,   0,   0,   0,   0,   0,   0,   0,   0,   0,   0,   0,   0,   0,  11,  12,   0,  11,  12,   0,  11,  12,   0,   4],
        [  3,   0,  11,  12,   0,  11,  12,   0,  11,  12,   0,  13,  14,   0,  13,  14,   0,  13,  14,   0,  13,  14,   0,  11,  12,   0,  11,  12,   0,  11,  12,   0,   4],
        [  3,   0,  15,  16,   0,  11,  12,   0,  15,  16,   0,  11,  12,   0,  11,  12,   0,  11,  12,   0,  11,  12,   0,  15,  16,   0,  11,  12,   0,  15,  16,   0,   4],
        [  3,   0,   0,   0,   0,  11,  12,   0,   0,   0,   0,  11,  12,   0,  11,  12,   0,  11,  12,   0,  11,  12,   0,   0,   0,   0,  11,  12,   0,   0,   0,   0,   4],
        [  3,   0,  13,   9,   9,  38,  39,   9,   9,   9,   9,  38,  12,   0,  11,  12,   0,  11,  12,   0,  11,  39,   9,   9,   9,   9,  38,  39,   9,   9,  14,   0,   4],
        [  3,   0,  11,  37,  10,  10,  10,  10,  10,  10,  10,  10,  16,   0,  11,  12,   0,  11,  12,   0,  15,  10,  10,  10,  10,  10,  10,  10,  10,  36,  12,   0,   4],
        [  3,   0,  11,  12,   0,   0,   0,   0,   0,   0,   0,   0,   0,   0,  11,  12,   0,  11,  12,   0,   0,   0,   0,   0,   0,   0,   0,   0,   0,  11,  12,   0,   4],
        [  3,   0,  11,  12,   0,  13,  14,   0,  13,   9,   9,   9,   9,   9,  38,  12,   0,  11,  39,   9,   9,   9,   9,   9,  14,   0,  13,  14,   0,  11,  12,   0,   4],
        [  3,   0,  11,  12,   0,  11,  12,   0,  11,  37,  10,  10,  10,  10,  36,  12,   0,  11,  37,  10,  10,  10,  10,  36,  12,   0,  11,  12,   0,  11,  12,   0,   4],
        [  3,   0,  11,  12,   0,  11,  12,   0,  11,  12,   0,   0,   0,   0,  11,  12,   0,  11,  12,   0,   0,   0,   0,  11,  12,   0,  11,  12,   0,  11,  12,   0,   4],
        [ 48,   0,  11,  12,   0,  11,  12,   0,  11,  12,   0,  13,  14,   0,  11,  12,   0,  11,  12,   0,  13,  14,   0,  11,  12,   0,  11,  12,   0,  11,  12,   0,  50],
        [ 52,   0,  11,  12,   0,  11,  12,   0,  11,  12,   0,  11,  12,   0,  11,  12,   0,  11,  12,   0,  11,  12,   0,  11,  12,   0,  11,  12,   0,  11,  12,   0,  52],
        [ 49,   0,  11,  12,   0,  11,  12,   0,  11,  12,   0,  11,  12,   0,  11,  12,   0,  11,  12,   0,  11,  12,   0,  11,  12,   0,  11,  12,   0,  11,  12,   0,  51],
        [  3,   0,  11,  12,   0,  11,  12,   0,  11,  12,   0,  11,  12,   0,  11,  12,   0,  11,  12,   0,  11,  12,   0,  11,  12,   0,  11,  12,   0,  11,  12,   0,   4],
        [  3,   0,  11,  12,   0,  11,  12,   0,  11,  12,   0,  11,  12,   0,  11,  12,   0,  11,  12,   0,  11,  12,   0,  11,  12,   0,  11,  12,   0,  11,  12,   0,   4],
        [  3,   0,  11,  12,   0,  11,  12,   0,  11,  12,   0,  11,  12,   0,  11,  12,   0,  11,  12,   0,  11,  12,   0,  11,  12,   0,  11,  12,   0,  11,  12,   0,   4],
        [  3,   0,  11,  12,   0,  11,  12,   0,  11,  12,   0,  11,  12,   0,  11,  12,   0,  11,  12,   0,  11,  12,   0,  11,  12,   0,  11,  12,   0,  11,  12,   0,   4],
        [  3,   0,  15,  16,   0,  11,  12,   0,  11,  12,   0,  11,  12,   0,  11,  12,   0,  11,  12,   0,  11,  12,   0,  11,  12,   0,  11,  12,   0,  15,  16,   0,   4],
        [  3,   0,   0,   0,   0,  11,  12,   0,  11,  12,   0,  11,  12,   0,  11,  12,   0,  11,  12,   0,  11,  12,   0,  11,  12,   0,  11,  12,   0,   0,   0,   0,   4],
        [ 39,   9,   9,   9,   9,  38,  12,   0,  11,  12,   0,  11,  12,   0,  11,  12,   0,  11,  12,   0,  11,  12,   0,  11,  12,   0,  11,  39,   9,   9,   9,   9,  38],
        [ 29,  10,  10,  10,  10,  10,  16,   0,  11,  12,   0,  15,  16,   0,  15,  16,   0,  15,  16,   0,  11,  12,   0,  11,  12,   0,  15,  10,  10,  10,  10,  10,  28],
        [  3,   0,   0,   0,   0,   0,   0,   0,  11,  12,   0,   0,   0,   0,   0,   0,   0,   0,   0,   0,  11,  12,   0,  11,  12,   0,   0,   0,   0,   0,   0,   0,   4],
        [  3,   0,  13,   9,   9,   9,  14,   0,  11,  12,   0,  24,  20,  17,  19,  19,  18,  20,  25,   0,  11,  12,   0,  11,  12,   0,  13,   9,   9,   9,  14,   0,   4],
        [  3,   0,  11,  37,  10,  10,  16,   0,  11,  12,   0,  22,  41,  41,  41,  41,  41,  41,  23,   0,  11,  12,   0,  11,  12,   0,  15,  10,  10,  36,  12,   0,   4],
        [  3,   0,  11,  12,  43,   0,   0,   0,  11,  12,   0,  22,  41,  41,  41,  41,  41,  41,  23,   0,  11,  12,   0,  11,  12,   0,   0,   0,  43,  11,  12,   0,   4],
        [  3,   0,  11,  39,   9,   9,   9,   9,  38,  12,   0,  22,  41,  41,  41,  41,  41,  41,  23,   0,  11,  12,   0,  11,  39,   9,   9,   9,   9,  38,  12,   0,   4],
        [  3,   0,  15,  10,  10,  10,  10,  10,  10,  16,   0,  26,  21,  21,  21,  21,  21,  21,  27,   0,  15,  16,   0,  15,  10,  10,  10,  10,  10,  10,  16,   0,   4],
        [  3,   0,   0,   0,   0,   0,   0,   0,   0,   0,   0,   0,   0,   0,   0,   0,   0,   0,   0,   0,   0,   0,   0,   0,   0,   0,   0,   0,   0,   0,   0,   0,   4],
        [  7,   2,   2,   2,   2,   2,   2,   2,   2,   2,   2,   2,   2,   2,   2,   2,   2,   2,   2,   2,   2,   2,   2,   2,   2,   2,   2,   2,   2,   2,   2,   2,   8]
    ],
    "lifeSystemPosition":{
        "X": -296,
        "Y": -232
    },
    "lifeSystemHitPoint": 3,
    "fruitSystemPosition":{
        "X": 280,
        "Y": -232
    },
    "gameScorePosition":{
        "X": -334,
        "Y": 280
    },
    "hightScorePosition":{
        "X": 324,
        "Y": 280
    },
    "ghostName":["blinky", "pinky", "inky", "clyde"],
    "ghostInitialPosition":[
        [-40, -120],
        [-56, -168],
        [-24, -168],
        [-8, -168]
    ],
    "ghostRestartPosition": {
        "X": -24.0,
        "Y": -168.0
    },
    "cherryPosition": {
        "X": -32.0,
        "Y": -216.0
    },
    "pacmanDeadImages":[
        "/Image/Character/Pacman_dead/Pacman_dead1.png",
        "/Image/Character/Pacman_dead/Pacman_dead2.png",
        "/Image/Character/Pacman_dead/Pacman_dead3.png",
        "/Image/Character/Pacman_dead/Pacman_dead4.png",
        "/Image/Character/Pacman_dead/Pacman_dead5.png",
        "/Image/Character/Pacman_dead/Pacman_dead6.png",
        "/Image/Character/Pacman_dead/Pacman_dead7.png",
        "/Image/Character/Pacman_dead/Pacman_dead8.png",
        "/Image/Character/Pacman_dead/Pacman_dead9.png",
        "/Image/Character/Pacman_dead/Pacman_dead10.png",
        "/Image/Character/Pacman_dead/Pacman_dead11.png",
        "/Image/Character/Pacman_dead/Pacman_dead12.png",
        "/Image/Character/Pacman_dead/Pacman_dead13.png"
    ],
    "pacmanUpImages":["/Image/Character/pacman/pacman_U_01.png", "/Image/Character/pacman/pacman_U_02.png"],
    "pacmanDownImages":["/Image/Character/pacman/pacman_D_01.png", "/Image/Character/pacman/pacman_D_02.png"],
    "pacmanRightImages":["/Image/Character/pacman/pacman_R_01.png", "/Image/Character/pacman/pacman_R_02.png"],
    "pacmanLeftImages":["/Image/Character/pacman/pacman_L_01.png", "/Image/Character/pacman/pacman_L_02.png"],
    "pacmanPosition":{
        "X": -8.0,
        "Y": 216.0
    },
    "Vulnerable":{
        "blinky":{
            "max":[-8,  280],
            "min":[-264,  104]
        },
        "pinky": {
            "max":[248,  280],
            "min":[-8,  104]
        },
        "inky": {
            "max":[ -8,  -56],
            "min":[-264, -232]
        },
        "clyde": {
            "max":[ 248,  -56],
            "min":[ -8, -232]
        }
    },
    "jumpPoint":[
        [[-264,   40],[ 248,   40]],
        [[ 248,   40],[-264,   40]]
    ]
}