{
    "name": "Level001",
    "mapSize": {
        "X": 39,
        "Y": 36
    },
    "map": [
        [  5,   1,   1,   1,   1,   1,   1,   1,   1,   1,   1,   1,   1,   1,  28,  29,   1,   1,   1,   1,   1,   1,   1,  28,  29,   1,   1,   1,   1,   1,   1,   1,   1,   1,   1,   1,   1,   1,   6],
        [  3,   0,   0,   0,   0,   0,   0,   0,   0,   0,   0,   0,   0,   0,  11,  12,   0,   0,   0,   0,   0,   0,   0,  11,  12,   0,   0,   0,   0,   0,   0,   0,   0,   0,   0,   0,   0,   0,   4],
        [  3,   0,  13,   9,   9,   9,   9,   9,   9,   9,   9,   9,  14,   0,  11,  12,   0,  13,  14,   0,  13,  14,   0,  11,  12,   0,  13,   9,   9,   9,   9,   9,   9,   9,   9,   9,  14,   0,   4],
        [  3,   0,  15,  10,  10,  10,  10,  10,  10,  10,  10,  10,  16,   0,  11,  12,   0,  11,  12,   0,  11,  12,   0,  11,  12,   0,  15,  10,  10,  10,  10,  10,  10,  10,  10,  10,  16,   0,   4],
        [  3,   0,   0,   0,   0,   0,   0,   0,   0,   0,   0,   0,   0,   0,  11,  12,   0,  11,  12,   0,  11,  12,   0,  11,  12,   0,   0,   0,   0,   0,   0,   0,   0,   0,   0,   0,   0,   0,   4],
        [  3,   0,  13,   9,   9,   9,   9,   9,   9,   9,   9,   9,  14,   0,  11,  12,   0,  11,  12,   0,  11,  12,   0,  11,  12,   0,  13,   9,   9,   9,   9,   9,   9,   9,   9,   9,  14,   0,   4],
        [  3,   0,  11,  37,  10,  10,  10,  10,  10,  10,  10,  36,  12,   0,  11,  12,   0,  11,  12,   0,  11,  12,   0,  11,  12,   0,  11,  37,  10,  10,  10,  10,  10,  10,  10,  36,  12,   0,   4],
        [  3,   0,  11,  12,   0,   0,   0,   0,   0,   0,   0,  11,  12,   0,  11,  12,   0,  11,  12,   0,  11,  12,   0,  11,  12,   0,  11,  12,   0,   0,   0,   0,   0,   0,   0,  11,  12,   0,   4],
        [  3,   0,  11,  12,   0,  13,  14,   0,  13,  14,   0,  11,  12,   0,  11,  12,   0,  11,  12,   0,  11,  12,   0,  11,  12,   0,  11,  12,   0,  13,  14,   0,  13,  14,   0,  11,  12,   0,   4],
        [  3,   0,  11,  12,   0,  11,  12,   0,  11,  12,   0,  11,  12,   0,  11,  12,   0,  11,  12,   0,  11,  12,   0,  11,  12,   0,  11,  12,   0,  11,  12,   0,  11,  12,   0,  11,  12,   0,   4],
        [  3,   0,  11,  12,   0,  11,  12,   0,  11,  12,   0,  11,  12,   0,  11,  12,   0,  11,  12,   0,  11,  12,   0,  11,  12,   0,  11,  12,   0,  11,  12,   0,  11,  12,   0,  11,  12,   0,   4],
        [  3,   0,  11,  12,   0,  11,  12,   0,  11,  12,   0,  11,  12,   0,  11,  12,   0,  11,  12,   0,  11,  12,   0,  11,  12,   0,  11,  12,   0,  11,  12,   0,  11,  12,   0,  11,  12,   0,   4],
        [  3,   0,  11,  12,   0,  11,  12,   0,  11,  12,   0,  11,  12,   0,  15,  16,   0,  15,  16,   0,  15,  16,   0,  15,  16,   0,  11,  12,   0,  11,  12,   0,  11,  12,   0,  11,  12,   0,   4],
        [  3,   0,  11,  12,   0,  11,  12,   0,  11,  12,   0,  11,  12,   0,   0,   0,   0,   0,   0,   0,   0,   0,   0,   0,   0,   0,  11,  12,   0,  11,  12,   0,  11,  12,   0,  11,  12,   0,   4],
        [ 35,   9,  38,  12,   0,  11,  12,   0,  11,  12,   0,  11,  12,   0,  24,  20,  20,  17,  19,  19,  19,  18,  20,  20,  25,   0,  11,  12,   0,  11,  12,   0,  11,  12,   0,  11,  39,   9,  33],
        [ 34,  10,  10,  16,   0,  11,  12,   0,  11,  12,   0,  15,  16,   0,  22,  41,  41,  41,  41,  41,  41,  41,  41,  41,  23,   0,  15,  16,   0,  11,  12,   0,  11,  12,   0,  15,  10,  10,  32],
        [ 48,   0,   0,   0,   0,  11,  12,   0,  11,  12,   0,   0,   0,   0,  22,  41,  41,  41,  41,  41,  41,  41,  41,  41,  23,   0,   0,   0,   0,  11,  12,   0,  11,  12,   0,   0,   0,   0,  50],
        [ 52,   0,  13,   9,   9,  38,  35,   9,  38,  35,   9,   9,  14,   0,  22,  41,  41,  41,  41,  41,  41,  41,  41,  41,  23,   0,  13,   9,   9,  38,  35,   9,  38,  35,   9,   9,  14,   0,  52],
        [ 52,   0,  15,  10,  10,  36,  37,  10,  36,  37,  10,  10,  16,   0,  26,  21,  21,  21,  21,  21,  21,  21,  21,  21,  27,   0,  15,  10,  10,  36,  37,  10,  36,  37,  10,  10,  16,   0,  52],
        [ 49,   0,   0,   0,   0,  11,  12,   0,  11,  12,   0,   0,   0,   0,   0,   0,   0,   0,   0,   0,   0,   0,   0,   0,   0,   0,   0,   0,   0,  11,  12,   0,  11,  12,   0,   0,   0,   0,  51],
        [ 35,   9,   9,  14,   0,  11,  12,   0,  11,  12,   0,  13,  14,   0,  13,   9,   9,   9,  14,   0,  13,   9,   9,   9,  14,   0,  13,  14,   0,  11,  12,   0,  11,  12,   0,  13,   9,   9,  33],
        [ 34,  10,  36,  12,   0,  11,  12,   0,  11,  12,   0,  11,  12,   0,  15,  10,  10,  36,  12,   0,  11,  37,  10,  10,  16,   0,  11,  12,   0,  11,  12,   0,  11,  12,   0,  11,  37,  10,  32],
        [  3,   0,  11,  12,   0,  11,  12,   0,  11,  12,   0,  11,  12,   0,   0,   0,   0,  11,  12,   0,  11,  12,   0,   0,   0,   0,  11,  12,   0,  11,  12,   0,  11,  12,   0,  11,  12,   0,   4],
        [  3,   0,  11,  12,   0,  11,  12,   0,  11,  12,   0,  11,  12,   0,  13,  14,   0,  11,  12,   0,  11,  12,   0,  13,  14,   0,  11,  12,   0,  11,  12,   0,  11,  12,   0,  11,  12,   0,   4],
        [  3,   0,  11,  12,   0,  11,  12,   0,  11,  12,   0,  11,  12,   0,  11,  12,   0,  11,  12,   0,  11,  12,   0,  11,  12,   0,  11,  12,   0,  11,  12,   0,  11,  12,   0,  11,  12,   0,   4],
        [  3,   0,  11,  12,   0,  11,  12,   0,  11,  12,   0,  11,  12,   0,  11,  12,   0,  11,  12,   0,  11,  12,   0,  11,  12,   0,  11,  12,   0,  11,  12,   0,  11,  12,   0,  11,  12,   0,   4],
        [  3,   0,  11,  12,   0,  11,  12,   0,  11,  12,   0,  11,  12,   0,  11,  12,   0,  11,  12,   0,  11,  12,   0,  11,  12,   0,  11,  12,   0,  11,  12,   0,  11,  12,   0,  11,  12,   0,   4],
        [  3,   0,  11,  12,   0,  15,  16,   0,  15,  16,   0,  11,  12,   0,  11,  12,   0,  11,  12,   0,  11,  12,   0,  11,  12,   0,  11,  12,   0,  15,  16,   0,  15,  16,   0,  11,  12,   0,   4],
        [  3,   0,  11,  12,   0,   0,   0,   0,   0,   0,   0,  11,  12,   0,  11,  12,   0,  11,  12,   0,  11,  12,   0,  11,  12,   0,  11,  12,   0,   0,   0,   0,   0,   0,   0,  11,  12,   0,   4],
        [  3,   0,  11,  39,   9,   9,   9,   9,   9,   9,   9,  38,  12,   0,  11,  12,   0,  11,  12,   0,  11,  12,   0,  11,  12,   0,  11,  39,   9,   9,   9,   9,   9,   9,   9,  38,  12,   0,   4],
        [  3,   0,  15,  10,  10,  10,  10,  10,  10,  10,  10,  10,  16,   0,  11,  12,   0,  11,  12,   0,  11,  12,   0,  11,  12,   0,  15,  10,  10,  10,  10,  10,  10,  10,  10,  10,  16,   0,   4],
        [  3,   0,   0,   0,   0,   0,   0,   0,   0,   0,   0,   0,   0,   0,  11,  12,   0,  11,  12,   0,  11,  12,   0,  11,  12,   0,   0,   0,   0,   0,   0,   0,   0,   0,   0,   0,   0,   0,   4],
        [  3,   0,  13,   9,   9,   9,   9,   9,   9,   9,   9,   9,  14,   0,  11,  12,   0,  11,  12,   0,  11,  12,   0,  11,  12,   0,  13,   9,   9,   9,   9,   9,   9,   9,   9,   9,  14,   0,   4],
        [  3,   0,  15,  10,  10,  10,  10,  10,  10,  10,  10,  10,  16,   0,  11,  12,   0,  15,  16,   0,  15,  16,   0,  11,  12,   0,  15,  10,  10,  10,  10,  10,  10,  10,  10,  10,  16,   0,   4],
        [  3,   0,   0,   0,   0,   0,   0,   0,   0,   0,   0,   0,   0,   0,  11,  12,   0,   0,   0,   0,   0,   0,   0,  11,  12,   0,   0,   0,   0,   0,   0,   0,   0,   0,   0,   0,   0,   0,   4],
        [  7,   2,   2,   2,   2,   2,   2,   2,   2,   2,   2,   2,   2,   2,  30,  31,   2,   2,   2,   2,   2,   2,   2,  30,  31,   2,   2,   2,   2,   2,   2,   2,   2,   2,   2,   2,   2,   2,   8]
    ],
    "lifeSystemPosition":{
        "X": -344,
        "Y": -256
    },
    "lifeSystemHitPoint": 3,
    "fruitSystemPosition":{
        "X": 328,
        "Y": -256
    },
    "gameScorePosition":{
        "X": -382,
        "Y": 248
    },
    "hightScorePosition":{
        "X": 372,
        "Y": 248
    },
    "ghostName":["blinky", "pinky", "inky", "clyde"],
    "ghostInitialPosition":[
        [-8,  96],
        [-56, 48],
        [-8,  48],
        [40,  48]
    ],
    "ghostRestartPosition": {
        "X": -8.0,
        "Y": 48.0
    },
    "cherryPosition": {
        "X": -8.0,
        "Y": 0.0
    },
    "ghostBFSMap":[
        [0, 0, 0, 0, 0, 0, 0, 0, 0, 0, 0, 0, 0, 0, 0, 0, 0, 0, 0, 0, 0, 0, 0, 0, 0, 0, 0, 0],
        [0, 1, 1, 1, 1, 1, 1, 1, 1, 1, 0, 0, 1, 1, 1, 1, 0, 0, 1, 1, 1, 1, 1, 1, 1, 1, 1, 0],
        [0, 1, 0, 0, 0, 0, 1, 0, 0, 1, 0, 0, 1, 0, 0, 1, 0, 0, 1, 0, 0, 1, 0, 0, 0, 0, 1, 0],
        [0, 1, 0, 0, 0, 0, 1, 0, 0, 1, 0, 0, 1, 0, 0, 1, 0, 0, 1, 0, 0, 1, 0, 0, 0, 0, 1, 0],
        [0, 1, 1, 1, 1, 1, 1, 0, 0, 1, 1, 1, 1, 0, 0, 1, 1, 1, 1, 0, 0, 1, 1, 1, 1, 1, 1, 0],
        [0, 1, 0, 0, 0, 0, 1, 0, 0, 0, 0, 0, 1, 0, 0, 1, 0, 0, 0, 0, 0, 1, 0, 0, 0, 0, 1, 0],
        [0, 1, 0, 0, 0, 0, 1, 0, 0, 0, 0, 0, 1, 0, 0, 1, 0, 0, 0, 0, 0, 1, 0, 0, 0, 0, 1, 0],
        [0, 1, 0, 0, 1, 1, 1, 1, 1, 1, 1, 1, 1, 0, 0, 1, 1, 1, 1, 1, 1, 1, 1, 1, 0, 0, 1, 0],
        [0, 1, 0, 0, 1, 0, 0, 0, 0, 1, 0, 0, 0, 0, 0, 0, 0, 0, 1, 0, 0, 0, 0, 1, 0, 0, 1, 0],
        [0, 1, 0, 0, 1, 0, 0, 0, 0, 1, 0, 0, 0, 0, 0, 0, 0, 0, 1, 0, 0, 0, 0, 1, 0, 0, 1, 0],
        [0, 1, 1, 1, 1, 1, 1, 1, 1, 1, 1, 1, 1, 1, 1, 1, 1, 1, 1, 1, 1, 1, 1, 1, 1, 1, 1, 0],
        [0, 1, 0, 0, 0, 0, 1, 0, 0, 1, 0, 0, 0, 1, 1, 0, 0, 0, 1, 0, 0, 1, 0, 0, 0, 0, 1, 0],
        [0, 1, 0, 0, 0, 0, 1, 0, 0, 1, 0, 1, 1, 1, 1, 1, 1, 0, 1, 0, 0, 1, 0, 0, 0, 0, 1, 0],
        [0, 1, 0, 0, 0, 0, 1, 0, 0, 1, 0, 1, 1, 1, 1, 1, 1, 0, 1, 0, 0, 1, 0, 0, 0, 0, 1, 0],
        [0, 1, 1, 1, 1, 1, 1, 0, 0, 1, 0, 1, 1, 1, 1, 1, 1, 0, 1, 0, 0, 1, 1, 1, 1, 1, 1, 0],
        [0, 1, 0, 0, 0, 0, 1, 0, 0, 1, 0, 0, 0, 0, 0, 0, 0, 0, 1, 0, 0, 1, 0, 0, 0, 0, 1, 0],
        [0, 1, 0, 0, 0, 0, 1, 0, 0, 1, 1, 1, 1, 1, 1, 1, 1, 1, 1, 0, 0, 1, 0, 0, 0, 0, 1, 0],
        [0, 1, 1, 1, 0, 0, 1, 0, 0, 1, 0, 0, 0, 0, 0, 0, 0, 0, 1, 0, 0, 1, 0, 0, 1, 1, 1, 0],
        [0, 0, 0, 1, 0, 0, 1, 0, 0, 1, 0, 0, 0, 0, 0, 0, 0, 0, 1, 0, 0, 1, 0, 0, 1, 0, 0, 0],
        [0, 0, 0, 1, 0, 0, 1, 1, 1, 1, 1, 1, 1, 0, 0, 1, 1, 1, 1, 1, 1, 1, 0, 0, 1, 0, 0, 0],
        [0, 1, 1, 1, 0, 0, 1, 0, 0, 0, 0, 0, 1, 0, 0, 1, 0, 0, 0, 0, 0, 1, 0, 0, 1, 1, 1, 0],
        [0, 1, 0, 0, 0, 0, 1, 0, 0, 0, 0, 0, 1, 0, 0, 1, 0, 0, 0, 0, 0, 1, 0, 0, 0, 0, 1, 0],
        [0, 1, 0, 0, 0, 0, 1, 0, 0, 1, 1, 1, 1, 1, 1, 1, 1, 1, 1, 0, 0, 1, 0, 0, 0, 0, 1, 0],
        [0, 1, 1, 1, 1, 1, 1, 0, 0, 1, 0, 0, 1, 0, 0, 1, 0, 0, 1, 0, 0, 1, 1, 1, 1, 1, 1, 0],
        [0, 1, 0, 0, 1, 0, 0, 0, 0, 1, 0, 0, 1, 0, 0, 1, 0, 0, 1, 0, 0, 0, 0, 1, 0, 0, 1, 0],
        [0, 1, 0, 0, 1, 0, 0, 0, 0, 1, 0, 0, 1, 0, 0, 1, 0, 0, 1, 0, 0, 0, 0, 1, 0, 0, 1, 0],
        [0, 1, 0, 0, 1, 1, 1, 1, 1, 1, 0, 0, 1, 1, 1, 1, 0, 0, 1, 1, 1, 1, 1, 1, 0, 0, 1, 0],
        [0, 1, 0, 0, 0, 0, 0, 0, 0, 1, 0, 0, 0, 0, 0, 0, 0, 0, 1, 0, 0, 0, 0, 0, 0, 0, 1, 0],
        [0, 1, 0, 0, 0, 0, 0, 0, 0, 1, 0, 0, 0, 0, 0, 0, 0, 0, 1, 0, 0, 0, 0, 0, 0, 0, 1, 0],
        [0, 1, 1, 1, 1, 1, 1, 1, 1, 1, 1, 1, 1, 1, 1, 1, 1, 1, 1, 1, 1, 1, 1, 1, 1, 1, 1, 0],
        [0, 0, 0, 0, 0, 0, 0, 0, 0, 0, 0, 0, 0, 0, 0, 0, 0, 0, 0, 0, 0, 0, 0, 0, 0, 0, 0, 0]
    ],
    "pacmanDeadImages":[
        "/Image/Character/Pacman_dead/Pacman_dead1.png",
        "/Image/Character/Pacman_dead/Pacman_dead2.png",
        "/Image/Character/Pacman_dead/Pacman_dead3.png",
        "/Image/Character/Pacman_dead/Pacman_dead4.png",
        "/Image/Character/Pacman_dead/Pacman_dead5.png",
        "/Image/Character/Pacman_dead/Pacman_dead6.png",
        "/Image/Character/Pacman_dead/Pacman_dead7.png",
        "/Image/Character/Pacman_dead/Pacman_dead8.png",
        "/Image/Character/Pacman_dead/Pacman_dead9.png",
        "/Image/Character/Pacman_dead/Pacman_dead10.png",
        "/Image/Character/Pacman_dead/Pacman_dead11.png",
        "/Image/Character/Pacman_dead/Pacman_dead12.png",
        "/Image/Character/Pacman_dead/Pacman_dead13.png"
    ],
    "pacmanUpImages":["/Image/Character/pacman/pacman_U_01.png", "/Image/Character/pacman/pacman_U_02.png"],
    "pacmanDownImages":["/Image/Character/pacman/pacman_D_01.png", "/Image/Character/pacman/pacman_D_02.png"],
    "pacmanRightImages":["/Image/Character/pacman/pacman_R_01.png", "/Image/Character/pacman/pacman_R_02.png"],
    "pacmanLeftImages":["/Image/Character/pacman/pacman_L_01.png", "/Image/Character/pacman/pacman_L_02.png"],
    "pacmanPosition":{
        "X": -8.0,
        "Y": -192.0
    },
    "Vulnerable":{
        "blinky":{
            "max":[-8,  304],
            "min":[-312,  112]
        },
        "pinky": {
            "max":[296,  304],
            "min":[-8,  112]
        },
        "inky": {
            "max":[ -8,  -64],
            "min":[-312, -256]
        },
        "clyde": {
            "max":[ 296,  -64],
            "min":[ -8, -256]
        }
    },
    "jumpPoint":[
        [[-312,   32],[296,   32]],
        [[296,   32],[-312,   32]],
        [[-312,   16],[296,   16]],
        [[296,   16],[-312,   16]]
    ]
}